{
  "questions": {
    "19": "18",
    "20": "19",
    "21": "22",
    "22": "23",
    "23": "24",
    "24": "25",
    "25": "26",
    "26": "27",
    "27": "28",
    "28": "29",
    "29": "30",
    "30": "31",
    "31": "32",
    "32": "33",
    "33": "34",
    "34": "35",
    "44": "36",
    "45": "37",
    "46": "38",
    "47": "39",
    "48": "40",
    "49": "41",
    "50": "42",
    "51": "43",
    "52": "44",
    "53": "45",
    "54": "46",
    "55": "47",
    "56": "48",
    "57": "49",
    "58": "50",
    "59": "51",
    "60": "52",
    "61": "53",
    "62": "54",
    "63": "55",
    "64": "56",
    "66": "20",
    "67": "57",
    "68": "58",
    "69": "59",
    "70": "60",
    "71": "61",
    "72": "62",
    "73": "63",
    "74": "21",
    "75": "64",
    "76": "65",
    "77": "66",
    "78": "67",
    "79": "68",
    "80": "69",
    "81": "70",
    "82": "71",
    "83": "72",
    "84": "73",
    "85": "74",
    "86": "75",
    "87": "76",
    "88": "77",
    "89": "78",
    "90": "79",
    "91": "80",
    "92": "81",
    "93": "82"
  },
  "papers": {
    "1": "4"
  }
}